111111111111
10000PP01111
111011100011
111111111111