111111111111111111111111111111
1P0000000000000011111110000001
111100001111000001000001000001
100000001000000001000001000001
100C00001100001111100000100001
100000000000010000000000000001
100000011111110000000011111001
100000010000000000000010001001
10000001000C000000000010001001
100000011111110000000011111001
100000000000000000000000000001
100000011111111111111000000001
100C000000000000000010000000E1
111111100000000000011000000001
100000000000000000011000000001
111111111111111111111111111111