1111111111111111111111
1000000010000000001111
100C0011100000000C0111
1000000000000011111111
100000000000001000C001
1000111111000010000011
10001000E1P00000111111
100010001100000000C001
10C0100011000000000001
1111100000000011111111
10000000000000111C0001
11110C0000000000000001
1111111111111111111111
