111111111111
1C00P0001111
100E01100C10
111111111111
