111111111111
1C00P0001111
100E01100C
111111111111