111111111111
1C00P0001111
100E01101C11
111111111111